	10x10 Maze

	 _ _ _ _ _ _ _ _ _ _
	| |_ _  |  _  |    _|
	|_ _  |  _|  _| |_  |
	|  _| |_ _| |  _ _| |
	|  _ _|   | | |  _  |
	| |    _| |_  | | | |
	| |_| | |_  |_| | | |
	| |  _|  _| |  _|  _|
	| |   |_   _|   | | |
	| |_|_  |_  |_| | | |
	|_ _ _ _|_ _ _ _|_ _|
